11111111111111111111111110
11111000000000000000111111
11111111000000000000000111
11111111111111111111111111
