11111111111111111111111111
100000000000000000000000E1
10000C00000000000000000001
10000000000000000000000001
100000000000000000000000C1
1000000000000000000C000001
1P000000000000000000000001
11111111111111111111111111
