11111111111111111111111111
100001000000000000000001C1
10001C10000000000000000001
10001000000000000000000001
10000000000000000000000001
10000000000000000000E00001
10000000000000000000000001
10000000000000000000000001
100000000000000000000000C1
1000000000000000000C000001
1P100000000000000000000001
11111111111111111111111111
